###                 #########
#   ###################   # #
# ####                # # # #
# ################### # # # #
#                     # # # #
########### ######### # # # #
#   ##                # # # #
# # ## ### ## ######### # # #
# #    #   ##B#         # # #
# # ## ################ # # #
### ##             #### # # #
### ## ########### ## # # # #
###             ##    # # # #
###### #### ### ####### # # #
###### ####             #   #
A      ######################
